0 0 0 0 0 0 
0 0 1 1 0 0 
0 0 2 2 1 1 
0 1 3 3 3 2 
0 1 3 3 4 3 
0 1 3 3 2 1 
