1 0 0 0 0 0 
1 3 2 2 1 0 
1 3 2 2 1 0 
0 3 3 4 1 0 
0 2 2 3 2 0 
0 1 1 2 1 0 
