0 2 2 4 3 2 
1 3 2 3 3 3 
1 3 2 3 2 1 
0 1 1 1 1 0 
0 0 0 0 0 0 
0 0 0 0 0 0 
