0 0 0 0 0 0 
0 0 0 0 0 0 
0 1 1 3 3 1 
1 2 2 3 3 1 
1 3 2 2 4 2 
1 2 2 1 2 1 
