1 1 1 2 1 0 
4 2 2 3 2 0 
2 3 3 3 1 0 
1 2 3 3 1 0 
0 1 1 1 0 0 
0 0 0 0 0 0 
