1 2 2 1 2 1 
1 3 4 2 3 2 
1 3 3 2 2 1 
0 2 2 2 1 0 
0 0 0 0 1 0 
0 0 0 0 0 0 
