0 1 1 1 1 0 
0 1 1 2 2 0 
0 1 2 3 4 0 
0 1 3 3 3 0 
0 0 2 3 3 0 
1 0 1 2 2 0 
