0 2 3 2 1 0 
1 3 2 2 1 0 
1 3 4 3 3 1 
0 1 2 2 3 1 
0 0 1 1 1 0 
0 0 0 0 0 0 
