0 0 0 0 0 0 
2 2 1 0 0 0 
2 2 2 1 1 1 
1 1 3 2 2 1 
0 1 4 2 2 1 
0 1 3 2 2 2 
