0 2 2 1 0 0 
0 2 3 2 1 1 
0 1 4 3 3 1 
0 0 2 2 3 2 
0 0 2 2 3 2 
0 0 0 0 0 0 
