0 1 1 0 0 0 
0 1 1 1 1 0 
0 2 2 3 2 1 
0 1 3 3 2 1 
0 1 3 4 2 1 
0 0 2 2 2 1 
