0 0 2 4 1 1 
0 0 2 3 1 1 
0 1 1 2 3 1 
0 2 2 2 1 0 
0 2 2 2 1 0 
0 2 2 2 1 0 
