0 1 0 2 2 2 
1 1 1 3 2 2 
1 1 1 3 2 2 
3 3 1 1 0 0 
3 4 1 1 0 0 
0 0 0 0 0 0 
