0 0 0 0 0 0 
1 1 1 0 0 0 
1 2 2 1 1 0 
1 3 4 2 2 1 
1 2 2 3 3 1 
0 1 1 3 3 1 
